........................................
........................................
........................................
.......XXXXXXXXXXXX.....XXXXX...........
.......X....................X...........
.......X....................X...........
.......X....................X...........
............................X...........
............................X...........
.................X..........X...........
.................X..........X...........
.................X..........X...........
.................X..........X...........
.................X..........X...........
........XXXXXXXXXXXXXXXXXXXXX...........
........X...................X...........
........X...................X...........
..................XXX.......X...........
..................X.........X...........
..................XXX.......X...........
............................X...........
........X...................X...........
........X...................X...........
........XXXXXXX......XXXXXXXX...........
........................................
........................................
